episode_length,episode_return,episode_return_imitation,episodes,steps,steps_per_second
40,64.79706525802612,42.06812208890915,214,3796,3.9128302517286246
41,66.45286881923676,45.244464635849,215,3837,4.946870006947968
41,66.71418571472168,45.16534662246704,216,3878,4.117116599249701
41,66.63178741931915,46.70443965494633,217,3919,4.158750738503588
41,66.58264946937561,45.31058391928673,218,3960,4.101021856771114
42,68.09314060211182,44.28044117987156,219,4002,4.102934768745574
44,71.06999182701111,42.12597607076168,220,4046,3.9485675883445506
44,71.59200048446655,43.020726189017296,221,4090,3.8786166067939765
43,69.68591856956482,45.80631224811077,222,4133,3.9237031650068865
45,73.14350128173828,49.869323030114174,223,4178,4.147493179974446
45,72.95796811580658,52.075684145092964,224,4223,4.4351703135405005
46,74.49412870407104,60.41161082684994,225,4269,4.321921220010422
45,73.37322974205017,58.133544608950615,226,4314,3.8651267840896346
44,71.65743899345398,54.82780730724335,227,4358,3.9319258716867314
43,69.22868847846985,44.18680201470852,228,4401,4.111752910547894
45,73.13224852085114,54.81992810964584,229,4446,4.162620629341828
51,85.73890948295593,53.026730090379715,230,4497,4.477897408455088
54,90.99366462230682,56.324435733258724,231,4551,4.0068327542956546
50,82.97965514659882,60.65723102539778,232,4601,4.062118992090289
54,91.18416404724121,64.87908275425434,233,4655,4.0125388153051045
61,103.80753564834595,71.93522358685732,234,4716,4.138141349124826
70,120.82671213150024,76.82835804671049,235,4786,4.290411861230273
135,255.36883115768433,93.1540067717433,236,4921,4.007292419459837
73,120.52188611030579,83.55670464038849,237,4994,4.196043288683182
64,100.99389266967773,70.67420773208141,238,5058,3.8732730860160527
93,137.57166516780853,89.56165344268084,239,5151,4.019741454144554
74,103.50247311592102,61.55210297740996,240,5225,4.09612859863197
80,112.2168847322464,63.134209886193275,241,5305,4.3980230096452875
97,140.57248175144196,86.65464293211699,242,5402,4.015773514858143
116,162.04546892642975,95.54988226294518,243,5518,4.283677276348395
75,103.54841578006744,64.69184689223766,244,5593,3.8928047175071816
87,108.73431825637817,66.18111744424095,245,5680,4.169376353109811
30,39.933443665504456,40.3225543894805,246,5710,4.040891033141318
28,36.15642535686493,40.891143310815096,247,5738,4.1789508331355485
24,26.02310037612915,28.288369936402887,248,5762,4.3248252436415315
24,28.837229371070862,32.98198044858873,249,5786,4.251060439307753
21,22.324344217777252,26.047533053904772,250,5807,4.076839574423868
24,25.331538021564484,19.231631697621197,251,5831,4.231727991783335
21,22.538652658462524,26.20985493157059,252,5852,3.980973308476765
24,28.526271283626556,30.4875516933389,253,5876,3.930297867857842
19,19.813634932041168,23.492298683617264,254,5895,4.045989112373739
22,24.4877969622612,25.05061017628759,255,5917,3.929033014335792
25,30.92818796634674,23.14184566680342,256,5942,3.999185041561431
20,21.33344155550003,23.575820460915565,257,5962,4.187800764193284
22,24.845500826835632,23.580718324519694,258,5984,4.378480191764558
21,23.202811062335968,20.38860602118075,259,6005,4.493872839259135
24,27.92175382375717,22.517111643217504,260,6029,4.365024093571674
23,26.537373423576355,24.549458403605968,261,6052,3.946992002255868
26,32.686983585357666,25.58981343638152,262,6078,3.6799290388439507
21,23.32756805419922,20.755212472286075,263,6099,3.92186702497628
30,40.218122124671936,30.532557082362473,264,6129,3.3669956764187225
47,74.18693923950195,56.99872987344861,265,6176,4.239104297313343
44,68.48334586620331,38.25532886385918,266,6220,4.160860328588907
48,76.15671360492706,48.098303535953164,267,6268,4.25639118007034
60,101.554150223732,55.93622508645058,268,6328,4.423284228371512
101,172.90616106987,71.29881930816919,269,6429,4.047913144876253
133,216.9781438112259,66.10157815727871,270,6562,5.608916408808189
150,250.5659919977188,61.61431529739639,271,6712,4.011312905998441
133,201.46204936504364,82.11731489188969,272,6845,4.154094705782633
211,366.3406460285187,68.6809123295825,273,7056,4.11826335104108
147,277.15865433216095,46.9363822612213,274,7203,3.9647286784070292
121,240.01064026355743,49.9404754897696,275,7324,4.155880889105086
118,233.72420358657837,66.6060748436139,276,7442,4.1943287749759
119,230.07290959358215,70.53921719110804,277,7561,4.230260610869446
113,202.4253809452057,60.9447537753731,278,7674,3.988755554653748
123,235.32599139213562,64.2374423763249,279,7797,4.181780282017844
122,217.29587244987488,57.16213818639517,280,7919,4.061222982480755
131,237.84458124637604,58.96376593224704,281,8050,4.181929861079837
142,245.8541740179062,81.06870969291776,282,8192,4.020694977846627
198,338.43303602933884,71.86800865427358,283,8390,4.096751774317961
194,332.3915721178055,85.93609638378257,284,8584,4.227366033634134
187,326.3580106496811,84.33859858382493,285,8771,3.8872546024315886
164,300.0343018770218,83.047518303385,286,8935,4.240207216433933
170,320.2704256772995,72.08231954957591,287,9105,4.091489255314215
114,261.18715929985046,171.71113158157095,389,38952,4.046546656094233
116,265.55529791116714,161.24229547614232,390,39068,4.220242227212221
117,255.95459014177322,140.87182101560757,391,39185,4.005096301694701
120,245.17731088399887,116.43840944254771,392,39305,4.069107399008716
123,232.75835692882538,106.16954078571871,393,39428,4.067788662241979
112,234.95905023813248,123.12805974762887,394,39540,4.133120058370213
112,220.55360954999924,111.2934575905092,395,39652,4.008945295689704
141,245.6687735915184,88.12564538931474,396,39793,4.074753843324897
116,236.32475519180298,122.82811975525692,397,39909,4.047289085002
114,236.09573352336884,114.91137796919793,398,40023,5.641480672678307
110,233.01101338863373,128.72639999724925,399,40133,4.153117533421064
110,230.83048111200333,127.38351998757571,400,40243,4.0476630550262955
112,253.8153970837593,163.23594488482922,401,40355,4.093507517639406
109,242.95762705802917,139.58705787267536,402,40464,4.089414019532065
108,234.43446803092957,131.59811236709356,403,40572,4.178791282063161
108,235.39723926782608,137.1452783551067,404,40680,3.9898595337450806
110,244.09840381145477,133.3295721798204,405,40790,3.8756410422260865
114,250.6454380750656,131.56378234410658,406,40904,4.341690254608117
115,257.7565989494324,141.7143856533803,407,41019,4.059436186687977
118,266.22398060560226,152.5425374750048,408,41137,4.133640099138969
115,260.2162662744522,163.80815180251375,409,41252,4.1357622848578375
118,269.60919976234436,163.66016052663326,410,41370,3.9942519583645
117,267.48209112882614,164.40762534318492,411,41487,4.13741245696673
116,267.11103773117065,171.09446727088653,412,41603,4.138188593020894
119,274.8578694462776,180.62160400906578,413,41722,3.9945185252031714
118,270.6074150800705,163.42356602102518,414,41840,4.037062271975721
118,272.5285539031029,185.30044154450297,415,41958,4.1847379019394495
117,270.2074785232544,186.6384840658866,416,42075,4.062184302560194
119,276.6904362440109,185.03457006136887,417,42194,4.031329900390999
122,284.6622923016548,186.6690203039907,418,42316,4.230655246331565
120,277.0681799054146,174.44545590528287,419,42436,3.983499402542141
120,277.612750351429,179.01486063818447,420,42556,4.115474116735375
123,281.126413166523,180.8317828644067,421,42679,4.076610079553966
123,286.7182637453079,174.47940498334356,422,42802,4.096780538956057
125,294.10386818647385,183.74691719003022,423,42927,4.043645344179939
124,285.9394684433937,176.75516212335788,424,43051,4.895165581853389
124,285.3774220943451,166.1896568890661,425,43175,4.866187084284954
128,296.93416035175323,169.75765455770306,426,43303,3.959489039084745
128,299.8027703166008,159.86459027347155,427,43431,4.224330142622812
126,294.15901416540146,170.93624138552696,428,43557,4.220962291343799
125,289.0517802834511,168.34855586849153,429,43682,3.9582506209510946
124,284.2053495645523,144.69726900663227,430,43806,4.1825539915478736
124,286.66505962610245,145.16059524705634,431,43930,3.9850937451222523
120,279.38302743434906,163.43309488333762,432,44050,4.272528912966122
122,284.3525784611702,176.43043136643246,433,44172,3.9301732893486006
122,281.3452730178833,167.24166380427778,434,44294,4.186694031571499
121,282.87090373039246,185.70690721366554,435,44415,4.1218645135294505
123,284.68197202682495,173.3160939477384,436,44538,4.12514780864198
120,276.9813116788864,172.93152327043936,437,44658,3.96158332933423
122,280.367170214653,178.70929324580356,438,44780,4.136524383202612
122,279.92111134529114,162.81826281314716,439,44902,4.023542387581854
121,282.49509155750275,184.7027617651038,440,45023,4.13768039098072
124,294.812499165535,183.5079064029269,441,45147,4.179720886412454
122,282.84345638751984,180.93474065279588,442,45269,4.0403613637373414
119,274.4250674843788,181.2028165757656,443,45388,4.035371829975663
120,279.20543044805527,179.16572930756956,444,45508,4.128969051761007
121,282.45629304647446,193.5980237564072,445,45629,3.996686136401503
121,282.3793092370033,192.82542358431965,446,45750,3.881364110731688
123,287.75456941127777,179.5408651381731,447,45873,4.306109399863946
121,279.7071192264557,198.85888286866248,448,45994,4.132747847918306
122,286.8758246898651,206.45222646510229,449,46116,4.448777230047392
132,322.5781999230385,207.58392869669478,450,46248,4.680371105609936
125,295.07620745897293,203.3411055910401,451,46373,3.986530859238038
132,320.97820764780045,200.91153249784838,452,46505,4.235654026937076
124,293.319169819355,201.84244754351676,453,46629,4.038325783477504
130,318.21477884054184,210.29901156702545,454,46759,4.0551656214884435
126,300.7205451130867,211.06694047502242,455,46885,4.064602001726233
132,322.9942371249199,211.67812472290825,456,47017,4.18629052022894
128,304.0621363520622,196.97529107658193,457,47145,3.9834695384222707
130,319.6803973913193,215.42911389819346,458,47275,4.120050827656345
131,322.1397005915642,219.646076324163,459,47406,4.031059624639027
126,300.69060039520264,217.25902019627392,460,47532,4.188489479069592
134,334.4593297839165,211.280815049191,461,47666,4.025940375279076
131,320.13672429323196,214.95082986261696,462,47797,4.047836914585062
130,324.88257455825806,205.93493815837428,463,47927,4.081280533096575
134,339.8875389099121,226.33109419746324,464,48061,4.235879920080652
132,333.2043551206589,227.59766371082515,465,48193,3.985646641949071
125,301.53626853227615,217.17789474187884,466,48318,4.091890239708385
132,332.3319815993309,219.1367059466429,467,48450,4.204269743669443
132,333.2313438653946,241.6857690915931,468,48582,4.104405334337915
131,329.01721328496933,217.19369935849681,469,48713,4.0986076743587745
130,323.0140764117241,208.46245987550355,470,48843,3.9128894708433433
130,326.4393924474716,223.0129258260131,471,48973,4.121509798821451
132,331.563678085804,191.57438480376732,472,49105,4.137506566674457
134,340.1377782225609,224.41145301715005,473,49239,5.3764511583108225
131,331.868040561676,187.84222235518973,474,49370,3.9709157397707804
133,339.31957960128784,218.04529665177688,475,49503,4.22380639847092
133,340.5003759264946,229.19452586653642,476,49636,4.169775187727268
133,336.9140348434448,228.812652533059,477,49769,4.099519653386625
132,341.14183950424194,220.10783292877022,478,49901,3.9988665470038613
132,334.18325823545456,225.35189320787322,479,50033,4.112711511287792
135,347.32570308446884,192.50343598390464,480,50168,4.171406470100858
137,361.14736580848694,212.77112676226534,481,50305,4.146516367395141
135,349.0099350810051,230.04187737265602,482,50440,3.9910727233535117
142,387.03554862737656,217.21153513039462,483,50582,4.172403202505653
139,370.89154583215714,228.46246893901844,484,50721,3.98684962769438
144,385.5257171392441,237.92057112103794,485,50865,4.236608388273076
147,406.7153775691986,219.24614656798076,486,51012,4.0143702055127735
149,415.95750480890274,223.32305324543267,487,51161,4.096611044162536
145,397.11138874292374,218.49154329230078,488,51306,4.181248671003044
145,387.61272871494293,216.16797701083124,489,51451,4.047563897598791
152,426.6617588400841,232.4428322070744,490,51603,4.105648120091112
151,424.33708143234253,218.1039235824719,491,51754,4.108692827359375
146,396.8162642121315,237.2465263493359,492,51900,4.069275320670168
152,426.37977784872055,231.18570683011785,493,52052,4.025138345578736
150,418.17273020744324,225.80739283259027,494,52202,4.254530711296035
147,402.4465022087097,223.78441026387736,495,52349,4.968185116013699
150,413.80490559339523,229.8056819946505,496,52499,4.114843653258762
95,214.16408210992813,236.58317019417882,497,52594,4.058736890149284
153,434.4591745734215,239.0494025303051,498,52747,4.183598881400867
150,416.2075833082199,227.66099005844444,499,52897,3.9636936603768356
93,209.1605698466301,231.89974276721478,500,52990,4.264957282339232
97,221.61935448646545,237.31818116642535,501,53087,3.7717666674781634
95,215.2890352010727,226.5767267346382,502,53182,4.0061184819456725
151,412.77320367097855,236.68895896989852,503,53333,4.350473105950797
93,211.75901091098785,232.8255295995623,504,53426,4.040161666841916
95,216.2813994884491,224.0920612551272,505,53521,4.127606570261517
151,423.6383926272392,233.1817937400192,506,53672,4.0597142298941
151,413.12861037254333,243.91700199479237,507,53823,4.044768222368866
153,430.9480266571045,245.15834713634104,508,53976,4.112749573749783
152,428.9056097269058,246.2748899627477,509,54128,4.006851669244657
156,439.2449466586113,258.95090035162866,510,54284,4.260233017590229
151,422.33142817020416,245.9500095397234,511,54435,4.117417901272451
153,427.30472630262375,252.2711948347278,512,54588,3.9823508216505576
143,383.50114899873734,258.3872577142902,513,54731,4.227849532110646
139,370.66162544488907,257.8785748966038,514,54870,3.991716545471173
138,368.90794748067856,249.40750184003264,515,55008,4.109048421206839
132,343.91058844327927,237.5842289114371,516,55140,4.011245784564183
136,358.8281926512718,256.9797159601003,517,55276,4.474886911358468
133,348.08785623311996,253.56624921783805,518,55409,4.937960520193426
131,341.6125364303589,258.6506249848753,519,55540,4.0329108484011
130,335.07990419864655,254.30595852714032,520,55670,4.0186620977235625
130,336.80483108758926,256.2468716651201,521,55800,4.356465729175339
129,339.1582677960396,220.36808367073536,522,55929,4.2293540669373995
134,356.58580869436264,247.5000808890909,523,56063,3.9267870326152914
129,341.65170192718506,237.5429504159838,524,56192,4.13491356336394
153,441.99212408065796,250.5941163012758,525,56345,4.103891698447925
150,417.8254053592682,245.36694139335304,526,56495,4.0242016405271785
140,373.24707412719727,255.0742919333279,527,56635,4.114303340531395
154,427.19566082954407,265.81870679790154,528,56789,4.075606203712917
139,372.2743641138077,249.5876378994435,529,56928,4.15961092963034
137,363.0082631111145,253.0028854571283,530,57065,3.9386515068086134
158,463.70771741867065,247.39373609027825,531,57223,4.149184013572308
156,443.5525881052017,242.90638688579202,532,57379,4.154190602949382
153,426.06681180000305,251.08928785007447,533,57532,4.0173004553508225
153,424.208792924881,234.5980991832912,534,57685,4.176140980255462
164,473.9397558569908,240.6352745250333,535,57849,4.0565480316827704
167,486.72717493772507,259.9874115809798,536,58016,4.117044964076053
161,463.8701644539833,254.14383811317384,537,58177,3.988014982936735
170,501.7246279120445,269.576681175502,538,58347,4.360167490012755
180,540.9014785289764,267.4912059942726,539,58527,4.720312671976752
163,475.98068875074387,262.6122416500002,540,58690,4.085416887531071
162,470.96168452501297,277.0497383736074,541,58852,4.044010713326967
173,511.3310781121254,270.43842066591606,542,59025,4.087830753419041
169,498.7299489378929,266.8007374203298,543,59194,4.118493094250295
188,569.5051382184029,258.66280334535986,544,59382,4.042422634338823
167,498.77287101745605,257.06334288511425,545,59549,4.242510092521952
170,510.40224331617355,242.63153254427016,546,59719,4.0309246031584065
173,515.6597935557365,258.07421529409476,547,59892,4.09316570825562
176,530.2903981208801,254.61542587250005,548,60068,4.083747737120624
208,629.7952447533607,273.85893392562866,549,60276,4.1281234920682195
204,617.9586682915688,273.47212214476895,550,60480,4.084034897606396
195,582.599900841713,261.2554353297455,551,60675,4.04828631923078
204,612.2508534789085,283.62460153736174,552,60879,4.202706859131741
191,566.6282629966736,268.2593806704972,553,61070,4.041182658130367
212,649.8753768205643,269.5858351450879,554,61282,4.109795990388523
203,621.4388701915741,268.52699137013406,555,61485,4.9513755973206095
217,669.5414165258408,275.26573004503734,556,61702,4.021266458188161
132,343.0213078260422,266.1665226854384,557,61834,4.0529873241981065
134,348.86824083328247,264.0066880378872,558,61968,4.186341515953947
208,638.5065471529961,284.79732151469216,559,62176,4.002873815006122
190,561.93164229393,262.3814067420317,560,62366,4.138120885198742
205,623.4536172151566,285.3413413707167,561,62571,4.11125938810455
189,554.190373301506,275.75158752826974,562,62760,4.140165811789767
192,574.6116188764572,268.9697351222858,563,62952,4.090300421174696
189,559.9074913263321,291.8759207050316,564,63141,3.9551352748706
135,353.34559977054596,270.17689126357436,565,63276,4.255020111194669
133,344.844240128994,262.1801795884967,566,63409,4.0814644878103765
215,661.0796159505844,250.64808483375236,567,63624,4.123314938767603
140,371.4649542570114,264.6805128008127,568,63764,4.159261096321196
192,561.5205234885216,276.2309512759093,569,63956,4.122422288743897
197,582.4930222034454,262.72882305237,570,64153,4.017533348412655
194,573.039038836956,249.35757224424742,571,64347,4.0897272498972725
170,484.7720314860344,275.80109084397554,572,64517,4.756211436209845
183,543.5851740241051,281.52923694392666,573,64700,4.351552707349807
195,579.748994410038,280.3625025281217,574,64895,4.065811815586934
195,580.2719603180885,256.87715793959796,575,65090,4.063453100037028
203,612.0945755243301,276.1692195041105,576,65293,4.03137813640292
189,560.1337323784828,289.49464023672044,577,65482,4.145269692537549
196,588.3014086484909,280.50350136938505,578,65678,4.012000459488396
185,550.8436200022697,298.0850758521119,579,65863,4.124960449334579
200,603.2393553853035,284.85556906368583,580,66063,4.141169441715542
197,590.3432077169418,284.25538493995555,581,66260,4.036534886519015
189,562.1609331965446,287.01961270626634,582,66449,4.178091369619414
191,569.8998522162437,291.29807611205615,583,66640,4.0527139097665374
162,459.4784734249115,278.7670536916703,584,66802,4.064312776345886
208,660.9630653858185,295.6286523616873,585,67010,4.124279094605122
212,658.5380651950836,276.77022796077654,586,67222,3.985289817178476
174,521.0683122873306,275.10982778389007,587,67396,4.095651477933569
172,508.0001251101494,282.69844884611666,588,67568,4.5093591041396826
203,618.3474093079567,293.2737109554,589,67771,4.383676198860631
201,627.7680150866508,286.77854448137805,590,67972,4.1102595797135955
209,650.5399917960167,291.895685242489,591,68181,3.98374987659985
196,642.2151102423668,280.95058436412364,592,68377,4.09859339608044
193,585.8930777907372,278.23750487552024,593,68570,4.132171681723668
195,593.0658468008041,288.3081235070713,594,68765,4.053798873686363
183,544.5882053971291,278.3439838094637,595,68948,4.200037303380373
203,622.8197005987167,287.9636934357695,596,69151,4.0083854281739315
198,606.4764211773872,293.5319685563445,597,69349,3.997772244444659
239,774.0049765110016,280.3423298128182,598,69588,4.104239570849352
206,646.6564102172852,271.62386940745637,599,69794,4.105888065506817
202,619.9991860985756,282.00793012510985,600,69996,4.131895804853631
197,599.8454646468163,274.07109180791304,601,70193,4.04090728273775
183,547.892450928688,283.90375697938725,602,70376,3.9970256654873504
198,607.1753050088882,263.32469483837485,603,70574,3.9920298246387023
210,651.478203356266,253.84047054639086,604,70784,4.983032023953842
202,620.5597085952759,268.1442271731794,605,70986,4.1092414209904025
210,652.7424299120903,259.1586351497099,606,71196,4.0722149243529735
181,538.702694952488,255.99243924953043,607,71377,4.00568907037122
103,243.38522112369537,258.58000246435404,608,71480,4.1077214473331125
199,603.5628215074539,261.7482274293434,609,71679,4.135941152456222
217,684.9748210310936,257.62379592331126,610,71896,4.066371456605828
181,526.2296440005302,252.82057073665783,611,72077,4.0909537384622325
160,435.45530116558075,235.1543094017543,612,72237,4.106209936623545
103,240.00789374113083,210.4055723324418,613,72340,4.044914659190721
159,431.6788946390152,211.1065908484161,614,72499,4.1157537778546445
166,455.97734051942825,197.66544220224023,615,72665,4.137562612880453
101,232.7682450413704,185.11097734421492,616,72766,4.074353029796345
192,576.972002863884,205.65341369295493,617,72958,3.982387886665826
170,484.252791762352,219.45407032966614,618,73128,4.094976632218474
214,669.5936189293861,251.80747336521745,619,73342,4.110316124371834
228,727.5906940102577,261.7709110566648,620,73570,4.073661444310573
213,671.4974891543388,243.4017845178023,621,73783,5.104512454209476
142,375.4565305709839,248.13876117765903,622,73925,4.1376176762759815
206,663.566348195076,253.19900253321975,623,74131,4.064145689865239
210,646.5188920497894,266.2610726216808,624,74341,4.069573998684713
188,597.721647799015,251.06707195169292,625,74529,4.12032425737402
210,656.693541765213,277.19421538244933,626,74739,4.073381575162666
144,379.0312178134918,248.19537390209734,627,74883,4.209386934952423
212,686.6963583230972,262.46672675269656,628,75095,4.020922231669319
206,670.5026189684868,267.6260549686849,629,75301,4.083981272762472
202,633.8447231054306,271.2326508020051,630,75503,3.8871787034082366
211,672.2693527340889,280.27524898259435,631,75714,4.207501996547084
212,655.4583224058151,267.1553348492598,632,75926,4.133283017049277
210,683.185810983181,274.1033199559897,633,76136,4.0587033959905225
203,656.1176726222038,254.26274678180926,634,76339,4.019313466639164
204,659.7374418973923,271.7251912718639,635,76543,4.0692229677456355
200,641.6643738746643,272.44182512676343,636,76743,4.246934496740286
220,703.7332119345665,277.7250611735508,637,76963,4.635538047225861
200,644.3274500370026,264.68382319877855,638,77163,4.120281636497524
210,687.9928703308105,281.4929023562581,639,77373,4.08439378025217
215,734.2191401124,271.1211033160798,640,77588,4.038899254595356
190,573.4184871912003,287.3900264133699,641,77778,4.096637762444422
211,671.3881019353867,282.9654592949664,642,77989,3.9888225296164044
210,680.5142546892166,280.9815091723576,643,78199,4.2098383838237075
205,706.8568431138992,283.6490462576039,644,78404,4.077929442046586
211,723.6316366791725,285.8885458644945,645,78615,4.10775797811588
167,490.55273324251175,276.42993436707184,646,78782,4.002914540661648
226,774.2637387514114,280.97651900560595,647,79008,4.087432295129096
217,737.4401578307152,288.5423039083835,648,79225,4.088996529826603
214,672.980536043644,291.8268575947732,649,79439,4.088507375889478
182,545.4220961928368,279.4081737441011,650,79621,4.150739277339411
211,716.1760508418083,288.4539881958626,651,79832,4.400078050090534
183,548.9267630577087,283.52196793537587,652,80015,4.398998284318894
211,689.1841368675232,285.82553809368983,653,80226,4.079402655457926
219,710.4652520418167,281.40941781911533,654,80445,3.955452842250696
226,762.2419897317886,312.7240136647597,655,80671,4.207226552203232
207,664.9008992314339,294.73864477477036,656,80878,4.137032205233173
215,699.009990811348,298.31048841332085,657,81093,3.977955612672015
228,793.6255149245262,306.17550109303556,658,81321,4.106550456873187
210,685.4643409252167,293.5401104427874,659,81531,4.045849564853046
209,707.8738146424294,286.08402054803446,660,81740,4.101140567838139
206,642.8837412595749,308.7159407120198,661,81946,4.1614597195658485
214,698.9075237512589,294.40335659869015,662,82160,3.9947038615150783
218,734.5620347857475,282.0663775128778,663,82378,4.137886293035682
205,664.3817577958107,283.9593279210385,664,82583,4.061291550804786
204,666.4029852747917,278.28775104228407,665,82787,4.048799953949076
185,553.633242547512,300.4431677754037,666,82972,4.869875780254751
189,579.1558012962341,303.2465203970205,667,83161,4.1931721763038405
224,743.6293724179268,313.5206736731343,668,83385,4.096978751676965
210,657.892853975296,296.83494873763993,669,83595,4.002045705261859
185,552.236654996872,282.6248141066171,670,83780,4.122794551919107
214,671.6951516866684,302.649957833346,671,83994,4.084924626566591
208,648.7062314152718,315.48574984120205,672,84202,4.097060601479792
200,615.7114585638046,302.48593625507783,673,84402,4.085609763720372
193,583.7378380298615,301.38038824824616,674,84595,4.031779580905651
188,568.0976569056511,295.55182166188024,675,84783,4.1128561256828595
209,656.5457836985588,299.1962005512323,676,84992,4.0618125337756705
222,697.486238360405,299.75275884754956,677,85214,4.081745724735955
212,668.3880906105042,293.16639045253396,678,85426,4.017382238308313
215,682.5939507484436,310.2332018595189,679,85641,4.106770329761947
188,566.9520694613457,291.48061639629304,680,85829,4.129271553203341
196,597.0696769356728,296.3700500719715,681,86025,4.998194625292227
188,568.938408613205,290.5750071729999,682,86213,4.0128438009773895
203,627.4467222094536,300.88532763998955,683,86416,4.124579167622532
187,560.4962072968483,293.7829071225133,684,86603,4.068457725902788
223,705.9247724413872,318.6419709525071,685,86826,4.064501395731308
204,630.8745226264,296.22537984279916,686,87030,4.1381626228072514
223,734.5548566579819,297.23144096159376,687,87253,4.021796488082919
186,555.4479862451553,294.3714718471747,688,87439,4.061760838686229
201,613.547017455101,306.2272281467449,689,87640,4.08473928210123
199,611.0605735778809,309.00381124252453,690,87839,3.9767677498185168
213,669.2010251283646,308.1058013481088,691,88052,4.237823623396533
225,757.2011724710464,302.5284229530953,692,88277,4.034687512148557
213,674.9047627449036,294.1760481330566,693,88490,4.083325706121762
219,704.7859609723091,318.26107860170305,694,88709,4.05085184935234
190,580.8145445585251,291.89011698786635,695,88899,4.093784819704724
216,704.7486683130264,306.61216016765684,696,89115,4.848057273719932
217,691.2206670045853,302.5665814790409,697,89332,4.0634649054728635
200,618.1758281588554,291.99969230010174,698,89532,4.100803907561908
222,721.3118081688881,311.0588690787554,699,89754,4.031324732093158
217,695.7266857624054,295.6346995191416,700,89971,4.094211840891604
224,741.3970913887024,305.8265310348943,701,90195,4.0307573520308315
216,692.1894226670265,301.90631334483624,702,90411,4.011365633157574
208,658.8405083417892,294.7397159419488,703,90619,4.202115409306254
216,670.1802296638489,307.255145461997,704,90835,4.089587720815677
204,646.8570456504822,301.5190312231425,705,91039,4.03784495047168
226,746.6057609915733,309.44579603348393,706,91265,4.11056153065182
202,634.3743913173676,293.3591686110012,707,91467,4.071410959470362
199,607.6170996427536,309.5400259546004,708,91666,4.0949126103605336
212,665.0814810395241,298.16846602247097,709,91878,4.070478656832443
211,667.323330283165,314.618684228044,710,92089,4.491468404884487
220,694.0027286410332,316.8330718912184,711,92309,4.377789536687538
207,640.4573691487312,289.64487357996404,712,92516,4.084202118743795
195,597.8860664963722,304.61418671533465,713,92711,4.047375490020798
199,623.5530346035957,290.7920196354389,714,92910,3.969081728328052
228,753.0768876671791,315.4249432636425,715,93138,4.144686988601511
214,679.2808725237846,294.82506645540707,716,93352,4.103248711962542
204,628.5181854963303,298.85525989579037,717,93556,4.14593164735243
197,604.2148798108101,290.84866722952574,718,93753,4.007475414792323
207,649.5573461055756,297.8726975424215,719,93960,4.087695422336401
213,678.7522676587105,301.15730243199505,720,94173,4.048985290612343
229,768.6370539665222,310.9573305834783,721,94402,4.0705600930205845
208,658.3345231413841,294.97620361763984,722,94610,4.0599662554936735
240,804.9594830870628,312.90029127825983,723,94850,4.033342590698765
213,677.2704265117645,291.601478026947,724,95063,4.097413219821471
201,634.557057082653,284.7666280865669,725,95264,5.0968113149747385
204,634.0125054717064,285.53325047995895,726,95468,4.16673364261921
195,600.7750120162964,273.9458418658469,727,95663,4.081048805467745
196,617.8842033743858,275.88011846435256,728,95859,4.082201924000396
214,675.4014629721642,305.8812147306744,729,96073,4.092978193587418
238,809.5102373361588,324.5580882782815,730,96311,4.079951129735766
227,743.1378416419029,308.98199489037506,731,96538,4.1520700036030425
211,669.0918001532555,298.8649835421238,732,96749,4.024678488907872
223,731.5614600777626,300.36281377915293,733,96972,4.042795419313333
223,726.9282981157303,310.7408195566386,734,97195,4.056641682589154
202,627.6980085968971,297.53503551427275,735,97397,4.127950405587671
215,704.2911947965622,297.84353178343736,736,97612,4.064545648747359
216,680.896742939949,308.57563849538565,737,97828,3.9316993051816755
234,769.6059420108795,305.18771387217566,738,98062,4.222098707300651
234,779.2911488413811,313.7099625347182,739,98296,4.714476171639156
226,753.6063767671585,313.75740193459205,740,98522,4.103192714704311
223,713.935578584671,306.34482682752423,741,98745,4.092993831250019
199,630.3751354217529,295.71368621941656,742,98944,4.0509325798752505
244,818.5501281023026,316.62767017795704,743,99188,4.068065217329692
230,772.4858177900314,314.7436307524331,744,99418,4.129308734381386
217,703.2883595228195,297.4126993112732,745,99635,4.059704968195734
217,706.4365563392639,304.6321136103943,746,99852,4.052772842671747
251,850.3532296419144,315.9134140731767,747,100103,4.105341591193628
241,797.8102241158485,310.8800499665085,748,100344,3.984155125541173
242,810.7844241261482,319.04908198094927,749,100586,4.178179593484113
210,679.4348713755608,296.05702290311456,750,100796,4.064393012613485
206,652.5842214226723,308.9409795724787,751,101002,4.051855816114891
229,743.6920921206474,312.95488572190516,752,101231,4.073513578289306
228,753.3977792859077,317.5542481113225,753,101459,4.803328127717502
203,628.3946185112,287.37860610336065,754,101662,4.016760874074001
221,733.8518425822258,302.9220216162503,755,101883,4.095530642024883
236,800.8249457478523,315.57224871451035,756,102119,4.020533835899109
241,829.4143177866936,319.0300231417641,757,102360,4.150589355678582
222,734.89917999506,308.42128160223365,758,102582,4.064464338836314
240,847.1477612257004,315.7926867074566,759,102822,3.9689268202551102
227,761.8146865367889,306.6784003744833,760,103049,4.213103815782385
225,735.6480104923248,305.9168586295564,761,103274,4.0674517495714
211,679.1521197557449,298.15489992056973,762,103485,4.108729866833232
243,823.766976416111,311.8218447130639,763,103728,4.112765363255635
269,945.9786357283592,346.1063869034406,764,103997,4.03707944573091
218,694.4034441113472,324.15654259035364,765,104215,4.075810322244953
213,689.6156631708145,306.8126893460285,766,104428,4.89862850788661
259,891.1625170707703,343.4656118603889,767,104687,4.057390794085906
225,711.7297207713127,315.1657379437238,768,104912,4.042042798749238
236,792.6272525191307,309.7668769842712,769,105148,3.952625550976972
243,839.9438664317131,331.44845692720264,770,105391,4.204573627829042
242,823.1042143106461,319.08334126276895,771,105633,4.104073551748403
225,758.9733970165253,324.3122883150354,772,105858,4.079116511970655
222,714.9621393680573,308.4776315866038,773,106080,4.0350080265042125
231,759.164444744587,322.8987753232941,774,106311,4.082914802116451
228,740.4618735313416,301.44545007986017,775,106539,4.133036662124237
216,656.3243886828423,346.1313399914652,776,106755,4.088493282779994
231,767.3173022270203,311.2355154217221,777,106986,4.0765251929509185
214,699.9879520535469,300.6387849994935,778,107200,4.134801768048332
236,784.9508615136147,321.32790610555094,779,107436,4.302620633061545
252,853.0853323936462,318.2827720446512,780,107688,4.368491225570911
226,727.0579655170441,312.2864950108342,781,107914,4.18683165409727
256,865.0085255503654,339.48005523718894,782,108170,4.060906397427625
229,745.985250890255,311.9184926706366,783,108399,4.091942311930182
246,831.0190929174423,323.91604620491853,784,108645,4.1082515117222735
220,722.4820389151573,313.64782539289445,785,108865,4.018912642193497
253,852.7534064650536,362.41602010733914,786,109118,4.094974881129896
245,830.9623175859451,346.5664234345313,787,109363,4.0632621857882
227,723.763409614563,323.4426517896354,788,109590,4.1105455145922365
223,729.6594933867455,302.4378981310874,789,109813,4.098522323595597
228,752.6936765909195,311.13100328226574,790,110041,4.112809527037746
234,744.9020503163338,327.6277659777552,791,110275,3.9686977618839983
225,709.0793455839157,311.5941109471023,792,110500,4.447398490379645
223,708.08677059412,300.820546541363,793,110723,4.5805949825585435
211,672.0633633732796,299.86144865490496,794,110934,4.0565669973399086
265,909.540225148201,337.5611047297716,795,111199,4.114718237805547
139,369.3320826292038,290.59190382249653,796,111338,3.976334528829003
215,692.7221428751945,296.7579278354533,797,111553,4.139970906291755
229,764.4103921055794,321.45591944269836,798,111782,4.135288378589726
195,608.5370339155197,274.80421124596614,799,111977,4.056436418486014
215,678.9557093977928,310.56960841920227,800,112192,4.1079851062565895
238,785.4073931574821,313.71037137077656,801,112430,4.00140401272725
230,752.9502654671669,319.97284618392587,802,112660,4.08039458703503
235,766.268469452858,317.5712222845759,803,112895,4.142560197228042
228,756.6746103167534,300.657495604828,804,113123,4.039256433171242
228,748.1398422122002,328.84203178063035,805,113351,4.0742747924372225
254,839.3044920563698,329.79488566645887,806,113605,4.596157425537675
227,738.9207266569138,319.77678767894395,807,113832,4.147186227815559
225,734.2563181519508,318.0572505518794,808,114057,4.116385954784609
218,727.8092451095581,305.44399585202336,809,114275,4.061759237891059
97,223.41145771741867,260.95272167026997,810,114372,4.123470388024456
215,685.9838249087334,303.3297671759501,811,114587,3.9436103759022854
252,855.5632970929146,331.4855187018402,812,114839,4.130547765903586
223,722.4963765740395,327.2050908273086,813,115062,3.9771148799836338
218,705.0478738546371,306.1930107846856,814,115280,4.115028763671574
201,625.1441243886948,297.9614946390502,815,115481,4.068921853292357
216,680.4683446884155,299.50154658500105,816,115697,4.142859164054787
235,780.5330932736397,312.885824855417,817,115932,4.067463457959369
237,762.2645186781883,342.85285362321883,818,116169,4.0344651960193145
217,707.1692393422127,306.25337694305927,819,116386,4.165057770475932
220,723.802446782589,297.4655292662792,820,116606,4.033419917998406
139,364.32411313056946,305.51431396231055,821,116745,5.355489718565284
247,845.1291149258614,374.2645385446958,822,116992,4.0586931055773885
235,776.4410946369171,311.6665483498946,823,117227,4.108342064613807
218,717.4125092625618,316.4513636305928,824,117445,4.079001516927839
210,656.155177295208,295.79311114083976,825,117655,3.911534530805685
205,631.1278667449951,283.6137004601769,826,117860,4.238291845870466
210,674.5450659394264,305.46580030955374,827,118070,4.097012059526609
234,769.8810882568359,332.92534798849374,828,118304,4.086492002498594
241,821.5650207996368,347.19881370075746,829,118545,4.088428759545766
223,724.3643197417259,318.9176219822839,830,118768,4.152578813595276
236,750.7765600085258,361.4875538526103,831,119004,4.058128394665585
222,698.9771146178246,320.92937220446765,832,119226,4.0774013939995015
226,716.9352105855942,310.68084261380136,833,119452,4.022475026563617
228,739.617960870266,354.71775462431833,834,119680,4.176153995141956
222,743.3259651660919,314.1243296856992,835,119902,4.579004234903593
229,730.8944220542908,325.60283741913736,836,120131,4.023727255013347
272,856.0191761851311,364.4576458754018,837,120403,4.157259531505174
231,748.3124306797981,334.14295616559684,838,120634,4.0337725140493745
244,836.7335442304611,335.9167706442531,839,120878,4.12705199630545
222,722.1673920154572,330.0056178155355,840,121100,4.023745772327268
244,791.9046931862831,335.58415639051236,841,121344,4.0926908395684265
222,725.0348128676414,322.2484038025141,842,121566,4.026749293168316
219,702.4667128324509,314.87766950391233,843,121785,4.162890656031885
235,778.2095246911049,351.9013585560024,844,122020,4.027394167130191
219,719.5845929384232,307.75923165958375,845,122239,4.095508734727436
247,794.8586032390594,349.0473064096295,846,122486,3.8747773853542125
264,770.5645553469658,340.33861018298194,847,122750,4.453128498435303
217,700.4441367387772,311.49325702525675,848,122967,4.950232761250977
252,850.2146151661873,356.27545515983365,849,123219,4.034077932392628
234,766.0760641694069,347.939720723778,850,123453,4.112864312507226
269,920.6365909576416,361.3152155149728,851,123722,4.009429646163681
248,804.9459159374237,354.26936227083206,852,123970,4.137224547970921
216,693.003022313118,301.95861719269305,853,124186,4.083461610605803
228,739.8861235380173,321.5311612887308,854,124414,4.026984371308993
265,882.6302339434624,342.55665985145606,855,124679,4.085226434704106
315,1024.8951660990715,399.7103197090328,856,124994,4.028947059463913
347,854.6706849932671,324.6224355935119,857,125341,4.141703588601325
276,839.3011232018471,342.58609719132073,858,125617,4.061773752859116
250,815.8604614138603,355.1154601839371,859,125867,4.511623595551835
275,834.5683110356331,356.92736486019567,860,126142,4.13594283858908
254,834.4643682837486,350.47243531787535,861,126396,4.17255362785435
228,725.8381690382957,335.96788062155247,862,126624,4.059474914792957
261,832.8963660597801,350.5832575079985,863,126885,4.104868293454601
255,775.3535745739937,353.67797979689203,864,127140,4.06852825701658
271,896.5390632152557,361.6640051016584,865,127411,4.076407203798257
280,952.3627371191978,336.9883588424418,866,127691,3.990590551988454
266,784.9987660646439,332.8144250670448,867,127957,4.124324691354228
285,977.3137835264206,369.26065945532173,868,128242,4.031066309264547
273,921.6620516180992,331.9694857685827,869,128515,4.090268397866957
255,836.9195725917816,343.42544900393113,870,128770,4.063871710679963
302,1002.1206892728806,333.5066261012107,871,129072,4.632449545248361
289,924.926544547081,314.95583747094497,872,129361,4.115671769546963
292,993.9190710186958,337.8675619047135,873,129653,4.030812027876887
266,913.0596535801888,338.4880816633813,874,129919,4.1201818206211875
289,877.7708909511566,369.45154967997223,875,130208,4.051506670704379
98,225.5499861240387,258.7794694006443,876,130306,4.068327290634011
94,206.91488254070282,254.33080272376537,877,130400,4.236914696172972
327,976.791328728199,359.42001726944,878,130727,4.026956590081082
95,211.11452335119247,245.51822131872177,879,130822,4.149889739538019
251,812.1998062729836,305.90181714948267,880,131073,4.111418892595653
325,1041.099996805191,362.07197142601945,881,131398,4.077082130649375
226,717.8790503144264,307.77404461055994,882,131624,4.059727065624748
323,1051.1073261499405,383.29252099851146,883,131947,4.146121980644386
290,947.8607677221298,368.5033238348551,884,132237,4.488987782376525
361,1034.7535843253136,360.4958630990004,885,132598,4.079507099637987
347,971.9121472835541,351.7179768963251,886,132945,4.072170044316884
318,926.9623271226883,367.36281876824796,887,133263,4.092141675602847
347,1228.185860991478,363.3382182335481,888,133610,4.104318762748062
285,990.3796064257622,342.11060193553567,889,133895,4.075061050577814
232,661.7834603190422,350.8306945115328,890,134127,4.083283567872397
238,647.8730008006096,326.3006332665682,891,134365,4.053022301119608
277,949.734827876091,341.3756410032511,892,134642,4.0354115915930455
326,988.8811029195786,409.65600843913853,893,134968,4.077390347518476
393,1157.0434577465057,349.1271507497877,894,135361,4.500528403980804
335,974.8263489603996,342.9121072208509,895,135696,4.101063864641048
440,1285.8297590613365,412.38245821371675,896,136136,4.095288051042121
263,904.1336182951927,338.9279339890927,897,136399,4.098254061038064
367,1045.2735914587975,355.676117218798,898,136766,4.103696779188562
561,1561.2882736325264,412.35039392276667,899,137327,4.091070076252583
287,964.0028765201569,356.25361295975745,900,137614,4.097383477582834
378,1107.1289043426514,346.87209949921817,901,137992,4.0845036173683456
270,910.5784480571747,349.8155666422099,902,138262,4.722247924991462
1000,2651.954934567213,503.1121982923796,903,139262,3.9635532991335793
823,2085.5964725464582,461.3373344121501,904,140085,4.091185194967688
470,1544.8465270996094,445.1818999033421,905,140555,4.098627164828346
332,1111.725659608841,415.7334057674743,906,140887,4.059351163999896
240,764.7089321613312,337.4094136817148,907,141127,4.278939606874648
370,1266.2140361070633,457.1180459514726,908,141497,4.3582529233785205
523,1568.5934746861458,405.7017511727754,909,142020,3.8088156340328823
309,1067.6762465238571,394.9806222334737,910,142329,4.0532644713259405
264,906.5676879882812,362.4445630973205,911,142593,4.176436571553475
289,960.8498853445053,350.1328722718172,912,142882,4.075161177717868
346,1181.6275364756584,402.67161583993584,913,143228,4.047653230151564
282,979.9797351360321,372.0292513342574,914,143510,4.072341656347953
409,1394.8539869189262,494.7628719707718,915,143919,4.070635428374741
598,1766.5693994760513,480.6509235566482,916,144517,4.3261734123738655
333,1127.5570929050446,424.00441705819685,917,144850,3.9972612970837056
275,947.5940172672272,351.6158493440598,918,145125,4.179533437641554
98,220.80770486593246,261.8807351142168,919,145223,4.018327654869861
577,1625.6435317397118,486.45122676948085,920,145800,4.098390926885744
652,1941.5243633389473,498.2009670883417,921,146452,3.8739392093186025
308,881.2760084271431,391.8266865834594,922,146760,4.059617873289779
284,993.1323024630547,382.2567423991859,923,147044,4.093680356656399
524,1323.9783282876015,406.7354695717804,924,147568,4.092741152111726
1000,3057.4692127108574,674.4170578441408,925,148568,4.080119064926241
883,2548.4719938635826,591.5863484473666,926,149451,4.051191609780867
466,1449.6175009608269,539.5388334784657,927,149917,4.06623321196436
405,1110.145968258381,422.84639903716743,928,150322,4.500917192443508
582,1770.5293201208115,563.1932519748807,929,150904,4.04613205785389
285,959.0587700605392,340.8718150581699,930,151189,4.086313040968478
289,1029.720902144909,392.81123046018183,931,151478,4.09134293423087
580,2015.084637761116,642.6926048162859,932,152058,4.070622773162084
284,975.9550832509995,363.6594154962804,933,152342,4.049097063289322
267,868.1023253798485,341.70934980385937,934,152609,4.066242061861774
284,1001.9775270223618,359.58570538740605,935,152893,4.054228202895008
1000,3194.655795276165,814.5905550538737,936,153893,4.1484322622297105
1000,3181.0618248581886,809.1870090662269,937,154893,4.060145100481758
384,1351.2017467617989,467.5934459846467,938,155277,4.0682409720356745
639,2171.996374309063,727.0289625755977,939,155916,3.7668401978506707
373,1329.1144280433655,556.7583537986502,940,156289,4.2951430187069395
445,1568.3862634897232,552.4441635841504,941,156734,3.743013016845137
394,1362.5641527175903,482.7789003108628,942,157128,3.662739779178711
440,1517.8188915252686,539.6588916941546,943,157568,3.74224806306476
431,1551.965339422226,498.0972358896397,944,157999,3.7601413313668015
320,989.0886979699135,467.74178344011307,945,158319,3.8106171724057156
446,1594.57921397686,570.1692109489813,946,158765,3.842961795181455
293,970.4520725607872,381.5261181551032,947,159058,3.69470127332199
321,1103.255664229393,457.6260990758892,948,159379,4.183794048677196
395,1318.2917583584785,526.4529941547662,949,159774,3.712680173749435
423,1474.4954937696457,549.6354506863281,950,160197,3.7870159091093774
286,995.1953195929527,394.2178783863783,951,160483,3.7698802446661257
270,902.6773037314415,334.68207128625363,952,160753,3.7702309376234107
284,990.5469571352005,412.7284768745303,953,161037,3.819364173655803
278,942.5581274628639,386.31818783213384,954,161315,3.9202419049521087
256,425.11477541923523,89.49286267803109,288,9361,4.074099724673374
487,649.2487179040909,98.89817220509576,289,9848,4.400636925579914
1000,1066.1387916207314,81.0679020204334,290,10848,4.119839620944392
309,477.9269506931305,98.59733088611392,291,11157,4.038245367407529
313,478.18771743774414,101.25758880909416,292,11470,4.101560740318542
302,416.46713280677795,96.29923937446438,293,11772,4.142969819097432
296,427.926500916481,91.18301565255388,294,12068,4.1451657488040885
300,439.1134181022644,93.61019854823826,295,12368,4.10052522056869
289,424.0763657093048,96.2668986209319,296,12657,4.461987196208069
388,523.1423132419586,100.0874133251491,297,13045,4.1975810342037905
1000,1047.6406244635582,92.89026144371019,298,14045,4.108018183712859
660,713.3771084807813,97.72123111093242,299,14705,4.071419168225952
367,540.3766966462135,105.30134851504408,300,15072,4.129647293827265
225,316.0628311634064,98.078220250085,301,15297,4.0471126706293035
260,437.05719286203384,103.31693686157087,302,15557,4.123382705577269
1000,1060.1475728452206,107.48382154791761,303,16557,4.128063479337726
1000,1028.2618399560452,104.6530125323261,304,17557,4.099162920514411
1000,1059.8894262611866,95.95370457274839,305,18557,4.059777204831435
483,667.1859784573317,93.20938267464226,306,19040,4.329073008182498
1000,1040.827014952898,95.68028951137967,307,20040,3.974488634335036
1000,1057.4909402346238,96.24080520537973,308,21040,4.029105106301943
794,986.9417080748826,96.32167583603587,309,21834,4.149264331420633
378,569.2192018851638,106.51083075639326,310,22212,4.104463844890796
1000,1016.1456759183202,103.68363534982927,311,23212,4.087052058077033
1000,1049.7710537028033,98.91318968219275,312,24212,3.960355716633851
1000,1036.8881618804298,98.37393214269832,313,25212,4.179177021598384
1000,989.7298836372211,102.78396553990024,314,26212,4.093628957315333
1000,1033.705345326569,96.32416566848406,315,27212,3.999278065349007
1000,1029.6053172573447,104.3658502772596,316,28212,4.213726794423484
1000,1033.5427908748388,102.3070113560243,317,29212,4.107237538277849
152,309.2577072381973,102.06739026401192,318,29364,4.147761666176867
186,340.5249398946762,98.5235469378531,319,29550,4.073751508485153
336,479.083629488945,100.38038217194844,320,29886,4.131689923851411
172,315.0502482652664,93.32335611572489,321,30058,4.123681825063954
160,299.840118765831,102.42990116868168,322,30218,4.050924392106734
150,286.0462501049042,102.34754320420325,323,30368,4.117663817490407
409,547.7837604185333,101.99296623544069,324,30777,4.022702004230385
225,364.84695386886597,107.114249675069,325,31002,5.030426477286237
284,330.0713672339916,103.9880814665812,326,31286,4.110657802067767
155,289.9696760773659,112.75214053690434,327,31441,4.023817998536188
163,298.3624266386032,114.31288104504347,328,31604,4.067404304501828
149,284.21051520109177,116.08792048692703,329,31753,4.163477112488744
139,265.31734389066696,103.67614295333624,330,31892,4.083478482127684
150,280.79003286361694,105.83416049927473,331,32042,4.037766806621527
146,279.60156536102295,113.91699159983546,332,32188,4.085742982515914
140,267.7079405784607,120.16866491734982,333,32328,4.106105154572997
116,231.83702719211578,101.54412693809718,334,32444,4.023093055430846
123,250.09271275997162,107.93542526476085,335,32567,4.031349983643671
125,258.4713073372841,113.99311312660575,336,32692,4.120705982454948
145,290.36570024490356,106.18905819719657,337,32837,4.149055884461347
122,249.16348779201508,102.14450315572321,338,32959,4.156581456050709
153,289.99784421920776,109.6375643745996,339,33112,4.027601217086132
126,229.38256573677063,118.45623313332908,340,33238,4.169140589469164
113,211.52950394153595,117.44042963441461,341,33351,3.99945011778748
113,211.57158505916595,121.40321514941752,342,33464,4.191534397280466
94,175.44812524318695,103.5211905008182,343,33558,4.0676403200718925
135,261.7710396051407,108.36907792557031,344,33693,4.119784393859308
117,248.92327445745468,117.02569472417235,345,33810,4.156472004963235
122,241.49774360656738,106.8135894946754,346,33932,5.593256425237252
104,215.83459198474884,102.10667505674064,347,34036,4.254034406248004
114,208.27476561069489,94.16726272786036,348,34150,3.922007580197153
107,196.2052949666977,84.87577008642256,349,34257,4.234099629712247
97,186.20889592170715,81.60043286532164,350,34354,4.045023492251557
103,219.4317046403885,102.18476775381714,351,34457,4.051285290671513
102,220.2388480901718,92.60846360772848,352,34559,4.17626866095623
117,213.95902109146118,87.13407975807786,353,34676,3.9698536330064984
104,228.38167083263397,105.42195200920105,354,34780,4.335307284932311
104,224.76096725463867,112.18835084140301,355,34884,4.022697615051362
112,239.6060475707054,117.44683396443725,356,34996,4.125195339125653
128,265.65672540664673,120.54608349967748,357,35124,4.0870169629681055
118,252.9776811003685,122.84144613146782,358,35242,4.099097493170757
120,275.1265187263489,113.88310278020799,359,35362,4.121290563833454
134,308.2431092262268,142.05744929448701,360,35496,4.118986608496111
112,255.42054319381714,117.93951424211264,361,35608,4.005154840984724
118,265.07148361206055,123.39843505807221,362,35726,3.989031289492128
118,273.6020626425743,130.521942416206,363,35844,4.025283603648018
128,306.2313240170479,131.69784339063335,364,35972,4.357841076582893
128,311.8428690433502,112.32901405391749,365,36100,4.018761694872719
119,276.8301661014557,138.94637553347275,366,36219,4.029787192849255
130,311.56545090675354,135.0512936633313,367,36349,4.184218103193717
133,315.9176150560379,148.92902060272172,368,36482,4.098824412407713
113,261.3285744190216,120.24693840928376,369,36595,3.944057725685162
115,267.6944309473038,126.0532847661525,370,36710,4.002110839939374
119,280.15643310546875,126.41491301823407,371,36829,4.234649965607618
121,285.843186378479,121.95370422769338,372,36950,4.5792448598594975
116,271.0786762237549,104.52450555562973,373,37066,4.669431764497284
126,293.70258724689484,108.29222620336805,374,37192,4.0302976887463045
118,275.33076202869415,126.94114486593753,375,37310,4.125111649498575
114,266.67735558748245,113.22816023230553,376,37424,4.01010637674223
120,280.3422611951828,151.92249532649294,377,37544,4.211673432597935
116,275.04794812202454,124.42597980238497,378,37660,3.8372336921363366
118,276.8681575059891,124.50152005627751,379,37778,4.2402360697519565
118,275.60478961467743,131.15550319943577,380,37896,4.091869796015946
116,270.93255615234375,142.56924502644688,381,38012,4.2047106952181705
116,269.4772615432739,152.29916740301996,382,38128,3.957911395592061
120,285.3179408311844,147.86278136167675,383,38248,3.9062454792102344
118,280.47764027118683,139.9406277826056,384,38366,4.157553621861106
115,268.1270900964737,141.39449082454666,385,38481,4.202171781036571
120,278.3275437951088,163.76382917538285,386,38601,4.0826390255503435
119,272.21146178245544,173.63148860272486,387,38720,3.990092634866474
118,276.96229034662247,164.9980507097207,388,38838,4.138393877856544
11,6.545771032571793,11.708652846107725,1,11,35.92389364544953
11,5.9421937465667725,10.258959125960246,2,22,403.3055123341317
11,6.090415373444557,10.629735185939353,3,33,515.4204258551734
11,6.1560225039720535,11.796689870476257,4,44,468.62779831796206
11,6.313446030020714,10.925449214759283,5,55,503.3970235237638
11,6.293267145752907,11.587912929651793,6,66,509.68100572236585
11,5.796251654624939,9.473637768591288,7,77,528.1773056140672
11,5.9594989866018295,10.140935547533445,8,88,491.2984272008008
10,5.4977084547281265,10.218651008675806,9,98,468.4907514967384
11,5.9577465653419495,9.45929982844973,10,109,487.9263943822839
11,6.113488778471947,11.181521152087953,11,120,517.1594274377053
10,5.5178781896829605,10.202571640315,12,130,532.7385654951671
10,5.516941353678703,9.60574943467509,13,140,545.3451391868523
11,6.439789071679115,11.065498401934747,14,151,537.9758165133336
10,5.43658210337162,10.76441043621162,15,161,519.2576911173012
11,5.995568588376045,10.362821076181717,16,172,492.04769319369495
12,7.345848321914673,12.713832835666835,17,184,523.0892537933902
11,6.060684010386467,10.659297549165785,18,195,533.8549228793261
11,6.2008789628744125,10.251465152192395,19,206,495.1580754907327
10,5.57987254858017,9.94344822037965,20,216,520.017357451926
11,5.957146763801575,9.88414564798586,21,227,586.974173685148
11,5.883272513747215,10.062084569217404,22,238,524.4429490531294
11,6.076636165380478,10.383713083632756,23,249,463.22634538152613
11,6.174921289086342,11.024989389057737,24,260,504.3931300630801
10,5.533886805176735,9.905544813198503,25,270,514.4617800019626
11,6.133288487792015,11.114267647557426,26,281,484.16299203509175
11,6.0052501410245895,10.396664720668923,27,292,504.4041587860368
11,6.515509873628616,11.677253576461226,28,303,505.3378313253012
10,5.59360334277153,10.246502757596318,29,313,466.8273843311407
11,6.249839931726456,11.13148703071056,30,324,540.8452394907744
11,6.13821217417717,11.201849564211443,31,335,510.69650882203183
10,5.243513107299805,9.316076548595447,32,345,464.3260896037905
11,6.0246623158454895,10.440846961690113,33,356,526.0034886504851
11,6.381744161248207,10.63439572713105,34,367,497.86709830581634
11,6.167806386947632,11.304372781713028,35,378,484.84987074129344
11,5.741796433925629,8.827054794295691,36,389,479.8276098758242
10,5.6318479180336,10.224620082066394,37,399,489.0974392462335
10,5.671218931674957,10.868177592172287,38,409,468.6896859984356
11,6.58375945687294,10.267400499084033,39,420,450.59520275021487
11,6.109453499317169,9.746807387389708,40,431,469.6104065305458
11,5.922070622444153,9.938824013137491,41,442,535.3043195767441
11,5.928603395819664,9.435284087492619,42,453,488.9139635677726
11,6.1503307074308395,11.56894658494275,43,464,487.158752784905
11,5.916763946413994,11.539496545650763,44,475,554.9289039102248
11,5.968053713440895,11.093544789822772,45,486,592.7735536340626
11,6.3270260244607925,10.548848763864953,46,497,554.322183775471
11,6.085867986083031,10.834262272750493,47,508,535.9136727416338
11,5.956131398677826,9.822065220563672,48,519,484.6054240278974
11,5.916737928986549,10.109525954787387,49,530,517.739768608396
11,6.4668096005916595,10.983904435357545,50,541,540.287889078858
11,5.791626483201981,10.3007459922228,51,552,506.58626406807576
11,6.121377795934677,11.232408148585819,52,563,491.6230033991497
11,5.997771382331848,9.717851057590451,53,574,487.26165154667484
11,6.0769955068826675,10.501560790638905,54,585,498.8576000691997
11,6.091386914253235,10.675378391868435,55,596,547.1955975141136
10,5.790972501039505,11.295184506918304,56,606,521.271143258392
10,5.694255962967873,11.814214730635285,57,616,498.6273880428451
11,6.304214745759964,11.621500721608754,58,627,513.4301198517711
11,6.3466667085886,11.112047064583749,59,638,537.5997017047109
11,6.161856800317764,10.840563745470718,60,649,583.1607260225492
10,5.710570156574249,10.148021865286864,61,659,559.9498030839063
11,6.092406049370766,10.579337114351802,62,670,550.2957264345606
10,5.730792611837387,10.151255714008585,63,680,515.0872539267338
10,5.577814936637878,10.321261409320869,64,690,542.3692343501481
11,6.256544291973114,11.622034603904467,65,701,545.9717649843204
10,5.461820185184479,9.552006914687809,66,711,532.4612806581018
11,6.2208055555820465,10.659433896071278,67,722,443.04042712554497
11,6.097615346312523,10.029763006430585,68,733,540.9149891552846
11,6.5323508232831955,12.598023531376384,69,744,538.9687744588391
11,6.41451895236969,10.108787607052363,70,755,555.376459542095
11,6.47676657140255,11.605244042526465,71,766,538.4781223375078
10,5.667340695858002,10.235812714672647,72,776,476.7229660612398
10,5.608292818069458,10.835795530234464,73,786,523.9670701695212
11,6.3425444811582565,11.831758720742073,74,797,552.0802201747039
11,6.061745181679726,10.69363861210877,75,808,572.8785139564915
11,6.238253951072693,10.592513027833775,76,819,577.3663371292704
11,6.181888252496719,10.590147289040033,77,830,535.8887740286892
10,5.531627178192139,10.056379959860351,78,840,499.7502621294443
10,5.7785002291202545,10.685962995397858,79,850,568.9583418114732
10,5.746584370732307,10.995000895345584,80,860,515.2074683699791
11,6.389511257410049,11.840989183692727,81,871,504.680033691027
11,6.509151220321655,10.726061891356949,82,882,536.4682681798098
11,6.3876489251852036,10.28227959643118,83,893,571.4735303589566
10,5.465892806649208,10.127879828272853,84,903,462.6870084168956
11,6.265771791338921,10.63254067208618,85,914,485.02826866267884
10,5.402186706662178,9.743007983022835,86,924,465.35642564711367
11,6.212084844708443,10.144855408987496,87,935,417.96372728425706
11,6.404696434736252,11.362552703358233,88,946,456.5025577092424
11,6.4692863672971725,11.536963710736018,89,957,458.18447604671485
10,5.729606717824936,11.239077631616965,90,967,500.2211117604265
11,5.932737335562706,10.098234243603656,91,978,454.2731506552583
11,5.79575514793396,9.292504964512773,92,989,460.1632107557125
11,6.097911298274994,10.467239169054665,93,1000,1.3608169689900214
29,35.557854771614075,29.323451232165098,94,1029,6.795241117318436
13,10.128585040569305,14.074460872390773,95,1042,6.672266908532374
12,9.574226915836334,14.557117894582916,96,1054,6.728413468524609
12,9.467656075954437,14.351448161993176,97,1066,6.889489526484587
11,7.742480367422104,13.473941835807636,98,1077,7.078145909941593
12,8.969649374485016,13.91171875060536,99,1089,7.02912487397777
12,9.541254490613937,14.7855773853953,100,1101,7.377474682077604
13,9.909352570772171,11.841093857772648,101,1114,7.365684412444108
12,8.701463848352432,11.531315265659941,102,1126,6.882930290082833
13,10.37221086025238,13.617888837354258,103,1139,6.584308041458258
12,9.565894603729248,15.147490570903756,104,1151,6.70271980618814
11,7.560248792171478,12.29890125215752,105,1162,7.357993866390659
12,8.649716168642044,13.203577615466202,106,1174,7.604714073321971
12,8.12382310628891,12.627472791034961,107,1186,7.589560135078589
12,8.288194507360458,12.143189435708337,108,1198,7.404028877856353
11,7.638595879077911,11.15615857631201,109,1209,7.27781150834307
11,7.00273272395134,13.194146209862083,110,1220,7.313533240685685
11,6.998087644577026,13.33818264392903,111,1231,7.718340310742143
11,7.0069791078567505,13.083387351070996,112,1242,7.841987267850047
12,8.240798830986023,13.30580942632514,113,1254,7.047751045680898
11,7.437478601932526,12.310993874678388,114,1265,6.109875499154183
11,7.878160715103149,12.620779788121581,115,1276,6.156520188917573
11,6.803259164094925,13.201374502532417,116,1287,6.186493145255261
11,7.323354333639145,12.870890312537085,117,1298,7.078315313069326
11,7.251290529966354,10.950540175836068,118,1309,6.574212584428421
11,6.816326469182968,11.914868597697932,119,1320,6.320220472501348
11,7.016147255897522,12.891099003143609,120,1331,6.5731382800637235
11,6.385687813162804,11.588967971561942,121,1342,6.616688812003657
11,7.666828483343124,11.922253009863198,122,1353,6.740212943969887
11,6.717728495597839,11.472120271791937,123,1364,6.763524823154576
11,7.364021748304367,10.686045389797073,124,1375,6.723414933631236
11,7.06947860121727,13.121814423298929,125,1386,5.872749015901504
11,7.06366041302681,12.730626348522492,126,1397,4.207814527390263
11,6.839616179466248,10.4897246658511,127,1408,3.9785247326025672
11,6.79237687587738,10.266055508633144,128,1419,4.376797350775252
11,7.0157469511032104,12.639922268455848,129,1430,4.38846943650768
11,6.91603696346283,11.064314254384954,130,1441,4.37555458652612
11,6.52416330575943,11.331282503146213,131,1452,4.052366902078763
11,7.459812819957733,10.86791563872248,132,1463,3.725417530786123
11,7.11440908908844,14.4486533254385,133,1474,3.7971372512871833
11,7.186215043067932,12.287743856548332,134,1485,3.83847046033764
11,7.110875099897385,12.516858542890986,135,1496,3.828723552569558
11,7.392315357923508,11.600450874248054,136,1507,3.6992931730320917
11,6.32115925848484,10.466899408173049,137,1518,3.4718180355602657
37,49.22326970100403,38.024137936736224,138,1555,3.9126701111474476
33,57.879178047180176,37.50981268112082,139,1588,4.06503812800591
18,19.70227700471878,19.51745317876339,140,1606,4.103246129639745
29,51.74712920188904,32.551647087559104,141,1635,4.100242596789856
28,50.45275390148163,29.705136962234974,142,1663,4.201365294670256
26,46.239299297332764,29.088278472423553,143,1689,4.09607261667199
25,44.46718907356262,35.792680472135544,144,1714,4.184172444842059
28,50.07487618923187,33.13341645896435,145,1742,3.9193702549929035
45,62.138599157333374,33.09795443655457,146,1787,4.105349470140962
32,50.848112881183624,28.070110274260514,147,1819,3.8887699104362476
29,45.771849036216736,31.785429700874374,148,1848,3.9411056302797642
30,47.282445549964905,34.67087660935067,149,1878,4.003251364043552
30,45.1627995967865,33.21853384684073,150,1908,3.9833970671824255
10,6.397231727838516,9.428582923486829,151,1918,4.299419210450542
9,5.098889861255884,8.929157053644303,152,1927,4.312651297728796
8,4.836478386074305,9.917026620998513,153,1935,4.5087110766884875
10,4.5957571268081665,8.916445290422416,154,1945,4.531541793420535
18,-0.7104901075363159,8.6179369657184,155,1963,3.918717167317282
18,-0.5337843131273985,8.931568126718048,156,1981,3.8886270230100597
19,-1.0278297746554017,8.483466255886015,157,2000,4.136202115794885
19,-0.7439930215477943,7.559287248761393,158,2019,3.9735203603601987
18,-0.6601782999932766,11.563581620866898,159,2037,3.702323607060759
18,-0.6942689940333366,10.96768413548125,160,2055,3.9811935828182174
18,-0.6329275351017714,9.31284916959703,161,2073,4.055683225814735
19,-0.6453794129192829,11.020201790321153,162,2092,4.119104330571302
18,-0.662363775074482,8.708204456197564,163,2110,4.131064290814777
19,-0.5108043476939201,9.680451774038374,164,2129,4.327763573066216
18,-0.9179727584123611,11.043149402248673,165,2147,4.261940763136489
18,-1.024574402719736,11.626347477198578,166,2165,4.2446514616848345
18,-0.6725073233246803,10.081567166314926,167,2183,4.257395526923346
18,-0.9775994531810284,10.877601888263598,168,2201,4.276157009657472
18,-0.42145902663469315,11.28649159061024,169,2219,4.139164125107382
18,-0.6943708071485162,10.376129451731686,170,2237,4.039417041774321
18,-1.2823299914598465,9.561436727002729,171,2255,4.108395621598761
19,-1.6228796392679214,8.10558542679064,172,2274,4.014112598159463
18,-0.38884564861655235,10.29536772199208,173,2292,4.163722154727221
19,-0.5359617620706558,12.184107996057719,174,2311,3.917186746942055
25,42.93215811252594,32.64201983809471,175,2336,4.037782121742495
22,38.33330714702606,28.1068122535944,176,2358,4.2230955296500525
29,47.39020800590515,38.563538402318954,177,2387,4.143935747043709
42,67.91675269603729,61.889576479792595,178,2429,4.424455983410171
44,71.57882368564606,58.34824764728546,179,2473,4.320067851629431
44,71.44710433483124,61.83335107564926,180,2517,3.995347153001898
42,67.7641829252243,49.751825109124184,181,2559,3.8702532262954614
33,53.668503761291504,48.05305480957031,182,2592,3.955018094492199
32,52.122334480285645,46.94956286251545,183,2624,4.192288164437931
32,51.8293776512146,47.75141963362694,184,2656,4.323299920979743
31,50.49269878864288,40.39775101840496,185,2687,4.272035617364352
32,52.100162625312805,38.5117352604866,186,2719,4.337133252450989
35,57.01928436756134,47.097838804125786,187,2754,4.087064222505266
35,56.82920837402344,48.83064451813698,188,2789,4.032580360282014
39,63.36444926261902,54.76358813047409,189,2828,4.134013964345419
39,63.25377309322357,45.952902510762215,190,2867,3.9471992085228575
38,61.456815123558044,41.57609936594963,191,2905,3.965595875971724
39,63.12298846244812,43.33893206715584,192,2944,4.102397772327182
41,66.68275618553162,47.2799012362957,193,2985,4.283403173893404
42,68.2908650636673,49.65210898220539,194,3027,3.907051438583109
40,64.96641838550568,45.325241059064865,195,3067,3.885300063717452
37,60.203951597213745,43.28502079844475,196,3104,4.193706906811214
37,60.12125074863434,44.879359021782875,197,3141,4.114119259667027
38,62.275012612342834,46.00840890407562,198,3179,4.394888322194332
38,61.772640228271484,47.443573862314224,199,3217,4.4749138349808275
37,60.2985543012619,46.33104383945465,200,3254,3.99170501211034
37,60.0996572971344,47.23867206275463,201,3291,3.973509602784353
37,60.394843101501465,44.059820622205734,202,3328,4.051530475076427
38,62.049068570137024,48.091654390096664,203,3366,4.11986891881493
37,60.2448468208313,42.3060178309679,204,3403,4.79432890454321
39,63.45659816265106,50.99340762197971,205,3442,7.588315807409379
38,61.78796875476837,42.22765485942364,206,3480,6.772018192350773
37,59.976779103279114,41.890550047159195,207,3517,3.979356784719524
41,66.9761575460434,50.53490123152733,208,3558,3.9679278146706793
39,63.7646244764328,45.554695941507816,209,3597,3.876100039666686
39,64.02110815048218,43.75336964428425,210,3636,3.5381937753405253
40,65.53518450260162,45.517010159790516,211,3676,4.121105845225912
41,66.62302196025848,43.8779733479023,212,3717,4.42262674402492
39,62.935683846473694,38.321152836084366,213,3756,4.127803810519058
